#####################
#                   #
#                   #
#                   #
#                   #
#      #            #
#      #            #
#           #       #
#           #       #
#                   #
#                   #
#       #           #
#       #           #
#                   #
#           #       #
#                   #
#                   #
#                   #
#                   #
#                   #
#####################
