#####################
#                   #
#                   #
#            BX     #
#            XX     #
#                   #
#                   #
#                   #
#       #           #
#        #          #
#       #           #
#                   #
#                   #
#                   #
#                   #
#             LXX   #
#             XXX   #
#             XXX   #
#                   #
#                   #
#####################
