#####################
#                   #
#                   #
#                   #
#                   #
#                   #
#                   #
#          LXX      #
#          XXX      #
#          XXX      #
#                   #
#                   #
#                   #
#                   #
#                   #
#                   #
#                   #
#                   #
#                   #
#                   #
#####################
